%%%%%%%%%%%%%%%%%%%%
%.           ..%   %
%.%%.%%.%%.%%.%% % %
%        P       % %
%%%.%%%%%.%%%%%%%% %
%.....             %
%%%%%%%%%%%%%%%%%%%%


