%%%%%%%%%%%%%%%%%%
%.............P .%
%%%%%%%%%%%%%%%%%%