%%%%%%%
%.  P %
%%%%% %
%%%%%.%
%%%%%%%
